R 1200 800
SO /Users/cmorel-a/cub3d/texture/bricks5.xpm
NO /Users/cmorel-a/cub3d/texture/wood2.xpm
WE /Users/cmorel-a/cub3d/texture/wood3.xpm
EA /Users/cmorel-a/cub3d/texture/wood4.xpm
S /Users/cmorel-a/cub3d/texture/cherry_trees.xpm
F 172,115,57
C 204,230,255

11111111111111111111111111111
10000020021100020000000000001
10110000011100000020000010021
10210000000000000000000012001
10110000011100000000000210001
10000000221120000111011110001
11110111111111011100000012021
11110111111111011101010010001
11000002110101011100000010001
10000000000000001101010010021
10000000000000001101010010021
10000000000000001101010010021
10000000000000001101010010021
10000000000000001101010010021
10000000000000001101010010021
10000000000000001101010010021
10000000000000001101010010021
10000000000000001101010010021
10000000000000001101010010021
10000000000000001101010010021
10000000000000001101010010021
10000000000000001101010010021
10000000000000001101010010021
10000000000000001101010010021
10000000000000001101010010021
10000000000000001101010010021
10000000000000001101010010021
10000000000000001101010010021
10000000000000001101010010021
10000000000000001101010010021
10000000000000001101010010021
10000000000000001101010010021
10000000000000001101010010021
10000000000000001101010010021
10000000000000001101010010021
10000000000000001101010010021
10000000000000001101010010021
10000000000000001101010010021
10000000000000001101010010021
10000000000000001101010010021
10000000000000001101010010021
10000000000000001101010010021
10000000000000001101010010021
10000000000000001101010010021
10000000000000001101010010021
10000000000000001101010010021
10000000000000001101010010021
10000000000000001101010010021
10000000000000001101010010021
10000000000000001101010010021
10000000000000001101010010021
10000000000000001101010010021
10000000000000001101010010021
10000000000000001101010010021
10000000000000001101010010021
10000000000000001101010010021
10000000000000001101010010021
10000000000000001101010010021
10000000000000001101010010021
10000000000000001101010010021
10000000000000001101010010021
10000000000000001101010010021
10000000000000001101010010021
10000000000000001101010010021
10000000000000001101010010021
10000000000000001101010010021
10000000000000001101010010021
10000000000000001101010010021
10000000000000001101010010021
10000000000000001101010010021
10000000000000001101010010021
10000000000000001101010010021
10000000000000001101010010021
10000000000000001101010010021
10000000000000001101010010021
10000000000000001101010010021
10000000000000001101010010021
10000000000000001101010010021
10000000000000001101010010021
10000000000000001101010010021
10000000000000001101010010021
10000000000000001101010010021
10000000000000001101010010021
10000000000000001101010010021
10000000000000001101010010021
10000000000000001101010010021
10000000000000001101010010021
10000000000000001101010010021
10000000000000001101010010021
10000000000000001101010010021
10000000000000001101010010021
10000000000000001101010010021
10000000000000001101010010021
10000000000000001101010010021
10000000000000001101010010021
10000000000000001101010010021
10000000000000001101010010021
10000000000000001101010010021
10000000000000001101010010021
10000000000000001101010010021
10000000000000001101010010021
10000000000000001101010010021
10000000000000001101010010021
10000000000000001101010010021
10000000000000001101010010021
10000000000000001101010010021
10000000000000001101010010021
10000000000000001101010010021
10000000000000001101010010021
10000000000000001101010010021
10000000000000001101010010021
10000000000000001101010010021
10000000000000001101010010021
10000000000000001101010010021
10000000000000001101010010021
10000000000000001101010010021
10000000000000001101010010021
10000000000000001101010010021
10000000000000001101010010021
10000000000000001101010010021
10000000000000001101010010021
10000000000000001101010010021
10000000000000001101010010021
10000000000000001101010010021
10000000000000001101010010021
11200000112101011111011110N01
11112111111121211111211112001
11111111111111111111111111111
