R 800 400
F 135,206,250
NO /Users/cmorel-a/cub3d/texture/bricks1.xpm
SO /Users/cmorel-a/cub3d/texture/bricks2.xpm
WE /Users/cmorel-a/cub3d/texture/bricks3.xpm
EA /Users/cmorel-a/cub3d/texture/bricks4.xpm
S /Users/cmorel-a/cub3d/texture/blue_trees.xpm
C 135,206,250
SO /Users/cmorel-a/cub3d/texture/bricks2.xpm

111111111
100E00001
111002001
100011101
111111101
100000001
111111111
