R 400 200
NO /Users/cmorel-a/cub3d/texture/bricks1.xpm
SO /Users/cmorel-a/cub3d/texture/bricks2.xpm
WE /Users/cmorel-a/cub3d/texture/bricks3.xpm
EA /Users/cmorel-a/cub3d/texture/bricks6.xpm
S /Users/cmorel-a/cub3d/texture/blue_trees.xpm
F 135,206,250
C 230,255,230

1111111
1000001
101002111
1011111S1
100000001
111111111
