R 400 80
NO /Users/cmorel-a/cub3d/texture/bricks1.xpm
SO /Users/cmorel-a/cub3d/texture/bricks2.xpm
WE /Users/cmorel-a/cub3d/texture/bricks3.xpm
EA /Users/cmorel-a/cub3d/texture/bricks4.xpm
S /Users/cmorel-a/cub3d/texture/blue_trees.xpm
F 135,206,250
C 230,255,230

111111111
1000000S1
111002001
100011101
111111101
1E0000001
111111111
