R 600 400
NO /Users/cmorel-a/cub3d/texture/bricks1.xpm
SO /Users/cmorel-a/cub3d/texture/bricks2.xpm
WE /Users/cmorel-a/cub3d/texture/bricks3.xpm
EA /Users/cmorel-a/cub3d/texture/bricks4.xpm
S /Users/cmorel-a/cub3d/texture/blue_trees.xpm
C 135,206,250
F 42,163,42

1111111
1222221
122S221
1222221
1111111
