R 1200 800
NO /Users/cmorel-a/cub3d/texture/bricks1.xpm
SO /Users/cmorel-a/cub3d/texture/bricks2.xpm
WE /Users/cmorel-a/cub3d/texture/bricks3.xpm
EA /Users/cmorel-a/cub3d/texture/bricks4.xpm
S /Users/cmorel-a/cub3d/texture/blue_trees.xpm
C 135,206,250
F 42,163,42

1 1 1 1 1 1 1 1 1 1 1 1 1 1 1 1 1 1 1 1 1 1
1 0 0 0 1 0 0 0 0 0 0 0 0 0 0 1 0 0 0 0 0 1
1 0 1 0 1 0 0 2 0 0 0 0 2 0 0 1 0 2 0 2 0 1
1 0 1 0 1 0 0 0 0 0 0 0 0 0 0 1 0 0 0 0 0 1
1 0 1 0 1 0 0 0 0 0 0 0 2 0 0 1 0 2 0 2 0 1
1 0 1 0 1 0 0 0 0 0 0 0 0 0 0 1 1 1 1 1 0 1
1 0 1 0 1 0 0 0 0 0 0 0 0 0 0 0 0 0 0 0 0 1
1 0 1 0 1 1 1 0 0 0 0 0 0 0 0 0 0 0 0 0 0 1
1 0 1 0 0 2 1 2 0 0 1 1 1 1 1 1 1 1 1 1 1 1
1 0 1 0 0 2 1 2 0 0 0 0 0 0 0 0 0 0 0 0 0 1
1 0 1 1 0 0 1 0 0 0 2 0 0 0 2 0 0 0 0 0 0 1
1 0 2 1 0 0 1 1 1 1 1 1 1 1 1 1 1 1 1 0 0 1
1 0 S 1 0 0 0 0 2 0 0 0 0 0 0 0 2 0 0 0 0 1
1 0 2 1 2 0 0 0 0 0 0 0 2 0 0 0 0 0 0 0 2 1
1 1 1 1 1 1 1 1 1 1 1 1 1 1 1 1 1 1 1 1 1 1
