R 1200 800
NO /Users/cmorel-a/cub3d/texture/bricks1.xpm
SO /Users/cmorel-a/cub3d/texture/bricks2.xpm
WE /Users/cmorel-a/cub3d/texture/bricks3.xpm
EA /Users/cmorel-a/cub3d/texture/bricks4.xpm
S /Users/cmorel-a/cub3d/texture/blue_trees.xpm
C 135,206,250
F 42,163,42

1111111111111111111111
1000100000000001000001
1010100200002001020201
1010100000000001000001
1010100000002001020201
1010100000000001111101
1010100000000000000001
1010111000000000000001
1010021200111111111111
1010021200000000000001
1011001000200020000001
1021001111111111111001
10S1000020000000200001
1021200000002000000021
1111111111111111111111
