R 800 600
NO /Users/cmorel-a/cub3d/texture/slab.xpm
SO /Users/cmorel-a/cub3d/texture/slab2.xpm
WE /Users/cmorel-a/cub3d/texture/bricks3.xpm
EA /Users/cmorel-a/cub3d/texture/bricks4.xpm
S /Users/cmorel-a/cub3d/texture/barrel.xpm
F 173,235,173
C 153,194,255

111111111
1020002S1
120000001
100011111
10021
12001
100211111
120000001
111111111
