R 1200 800
SO /Users/cmorel-a/cub3d/texture/wood1.xpm
NO /Users/cmorel-a/cub3d/texture/slab2.xpm
WE /Users/cmorel-a/cub3d/texture/basket.xpm
EA /Users/cmorel-a/cub3d/texture/bricks5.xpm
S /Users/cmorel-a/cub3d/texture/blue_trees.xpm
F 172,115,57
C 204,230,255

11111111111111
10000000000001
10000000000000111111111
11111000000000000000001
    1000000000011111111
    100000000001
    100000000001     111111
    11111111000111111100001    111   1111  11 1
    11111111000000000000001    1  1  1  11111
           10000000000000011111111   1111   1111
           100000N000000001    1  1  1  1   1111
   111111111000000000000001    1111111111111111111111
  1000000000000000000000001
  1000000000000000000000001
  1000000111111111111110011
  10000001            10001
  100000001111111    1100001
  10000000000000011111111101
   1111111111111000000000001
                11111100111
                     1001
             111     1001
            1000111111001
            1000000001111
            100011111
             111
