R 600 400
NO /Users/cmorel-a/cub3d/texture/bricks1.xpm
SO /Users/cmorel-a/cub3d/texture/bricks2.xpm
WE /Users/cmorel-a/cub3d/texture/bricks3.xpm
EA /Users/cmorel-a/cub3d/texture/bricks4.xpm
S /Users/cmorel-a/cub3d/texture/blue_trees.xpm
C 135,206,250
F 42,163,42

11111111111111111111111
10000000000000000000001
10000011111110000000001
10000000000001000000001
10010000000000000000001
10E00000000010000000001
10000100000000000000001
10000000001000000000001
11111111111111111111111
