R 800 400
NO ./text_nord.xpm
SO ./text_sud.xpm
WE ./text_ouest.xpm
EA ./text_est.xpm
S ./text_sprite.xpm
C 135,206,250
F 42,163,42

11111111111111111111111
10000000000000000S00001
10000011111110000000101
10000000000000010000001
10001111111000000000001
10000000000000000001001
10000000000000000000001
10000000000001000000001
11111111111111111111111
