R 800 600
NO /Users/cmorel-a/cub3d/texture/bricks1.xpm
SO /Users/cmorel-a/cub3d/texture/bricks2.xpm
WE /Users/cmorel-a/cub3d/texture/bricks3.xpm
EA /Users/cmorel-a/cub3d/texture/bricks4.xpm
S /Users/cmorel-a/cub3d/texture/pine.xpm
C 204,242,255
F 64,128,0

11111111111111111111111
10202020020002020202221
12000000020200000000021
12020202020202020202001
10000222000002202022201
10220200202022020220201
12220000000N00000000201
10202002020220200220001
11111111111111111111111
