R 600 400
NO /Users/cmorel-a/cub3d/texture/bricks1.xpm
SO /Users/cmorel-a/cub3d/texture/bricks2.xpm
WE /Users/cmorel-a/cub3d/texture/bricks3.xpm
EA /Users/cmorel-a/cub3d/texture/bricks4.xpm
S /Users/cmorel-a/cub3d/texture/blue_trees.xpm
C 135,206,250
F 42,163,42

11111111111111111111111
10202020020002020202021
12000000020200000000001
12020202020202020202021
10000222000002202020201
10220200222222220220201
10000100000N00000000001
10000000001000000000001
11111111111111111111111
